1111111111111111111111111111111111111111111111
1E0000000000000000000000000000000000000A0A0001
101001010010A01001010010A001001001000000010101
10000000000000000000C0010A0000000000000A010101
101001010010A001001010010A00101001000000010101
101001001010101000100100000000101100000A010101
101001010010A000101001010000011001000000010101
10100100101010100100101001C000100100000A010101
101001010010A000100101001000001001000000010101
101001001010101001001010010000100100000A010101
1PA000000C00C0001001010010000000000000AA000A01
1111111111111111111111111111111111111111111111