11111
1Y0E1
1C001
100P1
11111
