111111
1001E1
1C0011
100P11
111111
