111111
1001E1
1C1001
110P11
111111
