111111
1000E1
100011
100P01
111111
