11111
100E1
1C001
10001
11111
