111111111111111111111111111111111111111111111111111111111111
1E000000000000000000000000000010100100000000000000000A0A0001
101001010010A01001010010A00010100100C00001001001000000010101
10000000000000000000C0010A000000001000000000000000000A010101
101001010010A001001010010A0001010010000000101001000000010101
10100100101010100010010000000000000000000000101100000A010101
101001010010A000101001010010A0001010010000011001000000010101
101001001010101001001010010A000101001000C000100100000A010101
101001010010A0001001010010A000101001000000001001000000010101
101001001010101001001010010A0001010010000000100100000A010101
1PA000000C00C0001001010010A0001010010000000000000000AA000A01
111111111111111111111111111111111111111111111111111111111111
