1111111111111111111111111111111111
1E0000000000000C00000C00000A0A0001
101001010010A000101001000000010101
101001001010101000100100000A010101
101001010010A000101001000000010101
101001001010101000100100000A010101
101001010010A000101001000000010101
101001001010101000100100000A010101
101001010010A000101001000000010101
101001001010101000100100000A010101
101001010010A000101001000000010101
101001001010101000100100000A010101
101001010010A000101001000000010101
101001001010101000100100000A010101
101001010010A000101001000000010101
101001001010101000100100000A010101
101001010010A000101001000000010101
101001001010101000100100000A010101
101001010010A000101001000000010101
101001001010101000100100000A010101
101001010010A000101001000000010101
101001010010A000101001000000010101
101001001010101000100100000A010101
101001010010A000101001000000010101
101001001010101000100100000A010101
101001010010A000101001000000010101
101001010010A000101001000000010101
101001010010A000101001000000010101
101001001010101000100100000A010101
1PA000000C00C0000000000000AA000AC1
1111111111111111111111111111111111
