11111111111111111111111111111111111111111111111111111111111
1E00000000000000000000000000001010010000000000000000A0A0001
101001010010A01001010010A00010100100C0000100100100000010101
10000000000000000000C0010A00000000100000000000000000A010101
101001010010A001001010010A000101001000000010100100000010101
1010010010101010001001000000000000000000000010110000A010101
101001010010A000101001010010A000101001000001100100000010101
101001001010101001001010010A000101001000C00010010000A010101
101001010010A0001001010010A00010100100000000100100000010101
101001010010A0001001010010A00010100100000000100100000010101
101001010010A0001001010010A00010100100000000100100000010101
101001010010A01001010010A00010100100C0000100100100000010101
101001010010A01001010010A00010100100C0000100100100000010101
101001010010A01001010010A00010100100C0000100100100000010101
101001010010A01001010010A00010100100C0000100100100000010101
101001010010A01001010010A00010100100C0000100100100000010101
101001010010A0001001010010A00010100100000000100100000010101
101001010010A0001001010010A00010100100000000100100000010101
101001010010A0001001010010A00010100100000000100100000010101
101001010010A0001001010010A00010100100000000100100000010101
101001010010A0001001010010A00010100100000000100100000010101
101001010010A0001001010010A00010100100000000100100000010101
101001010010A01001010010A00010100100C0000100100100000010101
101001010010A01001010010A00010100100C0000100100100000010101
101001010010A0001001010010A00010100100000000100100000010101
101001010010A0001001010010A00010100100000000100100000010101
101001010010A01001010010A00010100100C0000100100100000010101
101001001010101001001010010A000101001000000010010000A010101
1PA000000C00C0001001010010A000101001000000000000000AA000A01
11111111111111111111111111111111111111111111111111111111111
