11111
10E01
1CP01
10E01
11111
