11111
10E01
1CP01
10P01
11111
