11111111
1001E001
1C001111
100P11
111111
